NO ./textures/42_NO.xpm
SO ./textures/42_SO.xpm
WE ./textures/42_WE.xpm
EA ./textures/42_EA.xpm

F 255,255,0
C 0,0,255

11111111111111111111111111111111
10000000001100000000000000000001
10110000011100000000000000010001
100100000000000N0000000000010111
10110000011100000000000000010001
10000000001100000000111011110001
11110111111111011100000001000101
11110111111111011101010010000001
11000000110101011100000011001011
10000000000000001100000011000011
10000000000000001101010011001111
11000000110101011111011111011
11110111111101011111011111011
11111111111111111111111111111
